PERSONAL INFORMATION

1. NAME : AS PER EDUCATIONAL DOCUMENTS AND IN ALL LETTERS IN CAPITALS
2. PRIMARY EMAIL : GMAIL ID WITH YOUR PROPER NAME(NO FANCY EMAIL ID'S)
3. SEC EMAIL : GMAIL ID WITH YOUR PROPER NAME (NO FANCY EMAIL ID'S)
4. CCPP ID : WILL BE ALOTED AFTER CCEE RESULTS
5. DOB : CHECK YOUR DATE OF BIRTH
6. CORRE. ADDRESS: CURRENT ADDRESS OF YOUR PG/HOSTEL WITH PIN CODE
7. PERMANENT ADD: YOUR LOCAL ADDRESS AS PER AADHAR / PARENT ADDRESS
8. NATIONALITY : AS PER YOUR AADHAR 
9. GENDER : CHECK YOUR GENDER
10. EXTRA CURR ACTIVITIES : SPORTS/ARTS ETC
11. LANGUAGES : ENGLISH, HINDI, MARATHI/ANY OTHER LANG.

ACADEMIC DETAILS:
1. 10TH /12TH :
2.SPECIALIZATION : GENERAL
3. INSTITUTE: NAME OF SCHOOL
4. BOARD : SSC/HSC/CBCE/ICSE
5. GRADE : I/II/ETC
6. OBTAINED MARKS :
7. TOTAL MARKS:
8. YEAR OF PASSING : YEAR MENTIONED ON YOUR MARKSHEET (DATE OF RESULT DECLARATION)

GRADUATION DETAILS
1. DIPLOMA/GRADUATION/POST GRADUATION
2. STREAM :ENG/MANAGEMENT
3. QUALIFICATION: eg. DCE -Diploma in Comp Eng (Ref to your Diploma/degree certificate)
4. SPECIALIZATION: 
5. UNIVERSITY : CHECK YOUR UNIVERSITY NAME IN DROP DOWN/ OTHER - FILL UNIVERSITY NAME IF NOT IN THE LIST
6. BACKLOGS : IF BACKLOG IS CLEARED IN SAME ACADEMIC YEAR COUNT IT AS 1 BACKLOG, IF CARRY FORWARD TO NEXT ACADEMIC YEAR THEN COUNT 1 MORE ADDITIONAL
7. NO OF ATTEMPTS : IF 3 YEARS DIPLOMA/4 YEARS DEGREE DONE IN SAME TIME FRAME ATTEMPT IS 1
IF TAKEN MORE THAN THAT COUNT ACCORDINGLY
8. GRADE/DIVISION : REF. TO YOUR DIP/DEGREE CERTIFICATE
9.COURSE DURATION: 3/4 YEARS
10. YEAR OF ADMISSION: REF. YOUR 1ST YEAR MARKSHEET
11. YEAR OF PASSING : REF. YOUR LAST SEM MARKSHEET (DATE OF RESULT)
12. ENTER MARKS : EITHER SEM / YEAR TOTAL MARKS AND OBTAINED MARKS
Note: Please convert your CGPA or Grading to marks according to respective university formulae.

ACADEMIC PROJECTS:
1. SELECT QUALIFICATION: PG DAC / COLLEGE PROJECT
2. DURATION : 1 MONTH FOR PG DAC 
3. GIT REPOSITORY : LINK MANDATORY
4. PROJECT DESCRIPTION : SHORT DESCRIPTION INCLUDING PROBLEM STATEMENT. OBJECTIVE, TECHNOLOGIES USED, FUTURE SCOPE OF THE PROJECT
5. PROJECT TITLE : SHORT NAME FOR YOUR PROJECT
6. PLATFORM USED : EXPECTED TO WRITE EACH TECHNOLOGY TAUGHT AND USED LIKE MS DOT NET/JAVA/JAVA SCRIPT, HTML, CSS, MY SQL/MS SQL, TESTING TOOL USED, GIT, AWS/AZURE, ETC

WORK EXP:
1.DESIGNATION : TITLE OF POSITION 
2.ORGANIZATION: NAME OF COMPANY
3. FROM DATE : DATE OF OFFER/JOINING
4.TO DATE : DATE OF RELEIVING / LAST DATE OF WORKING
5. NATURE OF WORK : TYPE OF DUTIES

OTHER INFORMATION:
1. AADHAR NUMBER : COMPULSORY (CARRY AADHAR CARD)
2. PASSPORT NO. : 
3. RELIGION : 
4. CAST ;
5. TECHNICAL CERTIFICATION: ANY COURSE CERTIFICATION AWARDED (CCAT IS NOT TECHNICAL CERTIFICATE)
6. TRAININGS : APART FROM ANY TECHNICAL TRAIININGS
7.EXTRA CURRICULAR : SPROTS/ARTS
8. HOBBIES : 